dataset,algorithm,descriptor,augmentation,rmse,cliff_rmse,n_compounds,n_cliff_compounds,n_compounds_train,n_cliff_compounds_train,n_compounds_test,n_cliff_compounds_test
CHEMBL1862_Ki,AFP,Attentivefp,0,0.80541501,0.81711169,790,329,630,261,160,68
CHEMBL1871_Ki,AFP,Attentivefp,0,0.80520489,0.99349615,647,133,512,103,135,30
CHEMBL2034_Ki,AFP,Attentivefp,0,0.92626561,1.05117408,750,245,592,191,158,54
CHEMBL204_Ki,AFP,Attentivefp,0,1.50592926,1.61129647,2733,1060,2161,829,572,231
CHEMBL2047_EC50,AFP,Attentivefp,0,0.88590713,0.90586099,631,245,498,197,133,48
CHEMBL214_Ki,AFP,Attentivefp,0,1.20950799,1.27856929,3261,1161,2590,920,671,241
CHEMBL2147_Ki,AFP,Attentivefp,0,1.14941526,1.09042981,1456,560,1163,449,293,111
CHEMBL218_EC50,AFP,Attentivefp,0,0.87945995,0.94843172,1009,335,804,263,205,72
CHEMBL219_Ki,AFP,Attentivefp,0,0.94691126,0.90780619,1834,700,1448,554,386,146
CHEMBL228_Ki,AFP,Attentivefp,0,0.98158689,1.0392545,1681,614,1332,484,349,130
CHEMBL231_Ki,AFP,Attentivefp,0,1.2780148,1.2479952,967,231,769,180,198,51
CHEMBL233_Ki,AFP,Attentivefp,0,1.26199091,1.41255023,3062,1215,2433,957,629,258
CHEMBL234_Ki,AFP,Attentivefp,0,1.09488312,1.09199539,3619,1569,2876,1227,743,342
CHEMBL235_EC50,AFP,Attentivefp,0,1.0387094,1.14396068,2325,864,1857,689,468,175
CHEMBL236_Ki,AFP,Attentivefp,0,1.04359234,1.15101927,2547,983,2033,784,514,199
CHEMBL237_EC50,AFP,Attentivefp,0,1.42536113,1.52981286,939,444,744,350,195,94
CHEMBL237_Ki,AFP,Attentivefp,0,1.02294832,1.0537159,2547,1070,2020,844,527,226
CHEMBL238_Ki,AFP,Attentivefp,0,0.91550941,0.86547249,1041,255,830,208,211,47
CHEMBL239_EC50,AFP,Attentivefp,0,1.00203996,1.16108454,1709,692,1357,541,352,151
CHEMBL244_Ki,AFP,Attentivefp,0,1.51298026,1.44925632,3082,1447,2439,1154,643,293
CHEMBL262_Ki,AFP,Attentivefp,0,1.0210095,1.01819628,856,164,685,126,171,38
CHEMBL264_Ki,AFP,Attentivefp,0,1.05862952,1.08176456,2753,1092,2185,868,568,224
CHEMBL2835_Ki,AFP,Attentivefp,0,0.76203225,1.02685043,609,54,485,43,124,11
CHEMBL287_Ki,AFP,Attentivefp,0,0.81700515,0.93382024,1243,427,987,335,256,92
CHEMBL2971_Ki,AFP,Attentivefp,0,0.87500056,1.06859235,973,150,776,117,197,33
CHEMBL3979_EC50,AFP,Attentivefp,0,0.84638924,0.94808782,1116,451,885,355,231,96
CHEMBL4005_Ki,AFP,Attentivefp,0,1.02692203,0.96464332,960,386,761,307,199,79
CHEMBL4203_Ki,AFP,Attentivefp,0,0.95247165,0.85723518,731,64,589,49,142,15
CHEMBL4616_EC50,AFP,Attentivefp,0,0.84133799,0.87471667,669,348,527,273,142,75
CHEMBL4792_Ki,AFP,Attentivefp,0,1.11432689,1.11939652,1471,783,1166,624,305,159
CHEMBL1862_Ki,GCN,Canonical,0,1.66475516,2.00670136,790,329,630,261,160,68
CHEMBL1862_Ki,MPNN,Canonical,0,1.74199995,1.92713193,790,329,630,261,160,68
CHEMBL1862_Ki,GAT,Canonical,0,2.15994334,2.34938471,790,329,630,261,160,68
CHEMBL1871_Ki,GCN,Canonical,0,0.77353769,0.84315256,647,133,512,103,135,30
CHEMBL1871_Ki,MPNN,Canonical,0,1.02927214,1.226415,647,133,512,103,135,30
CHEMBL1871_Ki,GAT,Canonical,0,0.71157824,0.83672253,647,133,512,103,135,30
CHEMBL2034_Ki,GCN,Canonical,0,0.89437379,0.92634414,750,245,592,191,158,54
CHEMBL2034_Ki,GAT,Canonical,0,1.05581854,1.08684586,750,245,592,191,158,54
CHEMBL2034_Ki,MPNN,Canonical,0,1.07523456,1.01861349,750,245,592,191,158,54
CHEMBL204_Ki,GCN,Canonical,0,1.40457821,1.52550052,2733,1060,2161,829,572,231
CHEMBL204_Ki,MPNN,Canonical,0,1.41835304,1.53472852,2733,1060,2161,829,572,231
CHEMBL204_Ki,GAT,Canonical,0,2.87090015,2.99760036,2733,1060,2161,829,572,231
CHEMBL2047_EC50,GCN,Canonical,0,2.73271457,2.54351265,631,245,498,197,133,48
CHEMBL2047_EC50,MPNN,Canonical,0,1.0850397,0.94955883,631,245,498,197,133,48
CHEMBL2047_EC50,GAT,Canonical,0,0.95369755,0.97911206,631,245,498,197,133,48
CHEMBL214_Ki,GCN,Canonical,0,1.03459044,1.02148486,3261,1161,2590,920,671,241
CHEMBL214_Ki,MPNN,Canonical,0,1.14304118,1.15696701,3261,1161,2590,920,671,241
CHEMBL214_Ki,GAT,Canonical,0,1.45516882,1.57158973,3261,1161,2590,920,671,241
CHEMBL2147_Ki,GCN,Canonical,0,2.57926103,1.78934105,1456,560,1163,449,293,111
CHEMBL2147_Ki,MPNN,Canonical,0,1.50530684,1.26253397,1456,560,1163,449,293,111
CHEMBL2147_Ki,GAT,Canonical,0,1.81977394,1.70532294,1456,560,1163,449,293,111
CHEMBL218_EC50,GCN,Canonical,0,1.06339807,1.10739631,1009,335,804,263,205,72
CHEMBL218_EC50,MPNN,Canonical,0,1.07747932,1.09991867,1009,335,804,263,205,72
CHEMBL218_EC50,GAT,Canonical,0,1.02862794,1.01073991,1009,335,804,263,205,72
CHEMBL219_Ki,GCN,Canonical,0,1.14262076,1.06698288,1834,700,1448,554,386,146
CHEMBL219_Ki,MPNN,Canonical,0,1.01073079,1.00135775,1834,700,1448,554,386,146
CHEMBL219_Ki,GAT,Canonical,0,1.05358989,1.0016983,1834,700,1448,554,386,146
CHEMBL228_Ki,GCN,Canonical,0,0.85539073,0.90823354,1681,614,1332,484,349,130
CHEMBL228_Ki,MPNN,Canonical,0,1.13661192,1.18997853,1681,614,1332,484,349,130
CHEMBL228_Ki,GAT,Canonical,0,1.17056312,1.14144559,1681,614,1332,484,349,130
CHEMBL231_Ki,GCN,Canonical,0,1.11474528,1.07479694,967,231,769,180,198,51
CHEMBL231_Ki,MPNN,Canonical,0,1.58382943,1.42550009,967,231,769,180,198,51
CHEMBL231_Ki,GAT,Canonical,0,2.16993632,2.2437978,967,231,769,180,198,51
CHEMBL233_Ki,GCN,Canonical,0,1.03372703,1.14427511,3062,1215,2433,957,629,258
CHEMBL233_Ki,MPNN,Canonical,0,1.1087575,1.20585733,3062,1215,2433,957,629,258
CHEMBL233_Ki,GAT,Canonical,0,1.31818284,1.44618793,3062,1215,2433,957,629,258
CHEMBL234_Ki,GCN,Canonical,0,0.95351258,0.9214454,3619,1569,2876,1227,743,342
CHEMBL234_Ki,MPNN,Canonical,0,1.21100129,1.10754577,3619,1569,2876,1227,743,342
CHEMBL234_Ki,GAT,Canonical,0,0.79183268,0.75466535,3619,1569,2876,1227,743,342
CHEMBL235_EC50,GCN,Canonical,0,0.90646314,1.06293784,2325,864,1857,689,468,175
CHEMBL235_EC50,MPNN,Canonical,0,1.11255003,1.26264379,2325,864,1857,689,468,175
CHEMBL235_EC50,GAT,Canonical,0,3.48407694,3.80015391,2325,864,1857,689,468,175
CHEMBL236_Ki,GCN,Canonical,0,1.40277825,1.47115828,2547,983,2033,784,514,199
CHEMBL236_Ki,MPNN,Canonical,0,1.39732668,1.30738598,2547,983,2033,784,514,199
CHEMBL236_Ki,GAT,Canonical,0,1.16903914,1.19017436,2547,983,2033,784,514,199
CHEMBL237_EC50,GCN,Canonical,0,1.31623343,1.24386083,939,444,744,350,195,94
CHEMBL237_EC50,MPNN,Canonical,0,1.37567843,1.3589968,939,444,744,350,195,94
CHEMBL237_EC50,GAT,Canonical,0,1.77032705,1.64614438,939,444,744,350,195,94
CHEMBL237_Ki,GCN,Canonical,0,0.95530206,0.99959545,2547,1070,2020,844,527,226
CHEMBL237_Ki,MPNN,Canonical,0,1.32008874,1.41083245,2547,1070,2020,844,527,226
CHEMBL237_Ki,GAT,Canonical,0,0.96614076,1.03310803,2547,1070,2020,844,527,226
CHEMBL238_Ki,GCN,Canonical,0,0.82636973,0.92546244,1041,255,830,208,211,47
CHEMBL238_Ki,MPNN,Canonical,0,1.09348545,1.16192054,1041,255,830,208,211,47
CHEMBL238_Ki,GAT,Canonical,0,3.67631835,4.06816981,1041,255,830,208,211,47
CHEMBL239_EC50,GCN,Canonical,0,0.83102609,1.0007665,1709,692,1357,541,352,151
CHEMBL239_EC50,MPNN,Canonical,0,1.09818337,1.21339787,1709,692,1357,541,352,151
CHEMBL239_EC50,GAT,Canonical,0,1.11590624,1.17043602,1709,692,1357,541,352,151
CHEMBL244_Ki,GCN,Canonical,0,1.92193593,1.82996625,3082,1447,2439,1154,643,293
CHEMBL244_Ki,MPNN,Canonical,0,1.52063476,1.5156761,3082,1447,2439,1154,643,293
CHEMBL244_Ki,GAT,Canonical,0,1.63333519,1.58667034,3082,1447,2439,1154,643,293
CHEMBL262_Ki,GCN,Canonical,0,0.84354396,0.89698021,856,164,685,126,171,38
CHEMBL262_Ki,MPNN,Canonical,0,1.1872511,1.25970427,856,164,685,126,171,38
CHEMBL262_Ki,GAT,Canonical,0,1.02774824,1.11797684,856,164,685,126,171,38
CHEMBL264_Ki,GCN,Canonical,0,0.86355102,0.88660565,2753,1092,2185,868,568,224
CHEMBL264_Ki,MPNN,Canonical,0,1.12152284,1.13319067,2753,1092,2185,868,568,224
CHEMBL264_Ki,GAT,Canonical,0,1.10174175,1.10447981,2753,1092,2185,868,568,224
CHEMBL2835_Ki,GCN,Canonical,0,0.99644664,1.06137034,609,54,485,43,124,11
CHEMBL2835_Ki,MPNN,Canonical,0,0.94158303,1.27714902,609,54,485,43,124,11
CHEMBL2835_Ki,GAT,Canonical,0,0.79638968,1.00211676,609,54,485,43,124,11
CHEMBL287_Ki,GCN,Canonical,0,0.96138979,1.08844688,1243,427,987,335,256,92
CHEMBL287_Ki,MPNN,Canonical,0,1.1594959,1.25375156,1243,427,987,335,256,92
CHEMBL287_Ki,GAT,Canonical,0,1.16890286,1.25660406,1243,427,987,335,256,92
CHEMBL2971_Ki,GCN,Canonical,0,0.96088583,0.92977308,973,150,776,117,197,33
CHEMBL2971_Ki,MPNN,Canonical,0,1.44284925,1.51044193,973,150,776,117,197,33
CHEMBL2971_Ki,GAT,Canonical,0,0.86756293,1.05021898,973,150,776,117,197,33
CHEMBL3979_EC50,GCN,Canonical,0,0.81448359,0.94873062,1116,451,885,355,231,96
CHEMBL3979_EC50,MPNN,Canonical,0,1.12140855,1.09359242,1116,451,885,355,231,96
CHEMBL3979_EC50,GAT,Canonical,0,2.25385713,2.41838378,1116,451,885,355,231,96
CHEMBL4005_Ki,GCN,Canonical,0,0.89342529,0.95031193,960,386,761,307,199,79
CHEMBL4005_Ki,MPNN,Canonical,0,1.10362863,1.07791451,960,386,761,307,199,79
CHEMBL4005_Ki,GAT,Canonical,0,1.42588653,1.47641125,960,386,761,307,199,79
CHEMBL4203_Ki,GCN,Canonical,0,0.97435882,0.96788342,731,64,589,49,142,15
CHEMBL4203_Ki,GAT,Canonical,0,1.12863009,1.06084638,731,64,589,49,142,15
CHEMBL4203_Ki,MPNN,Canonical,0,1.0003965,0.89735098,731,64,589,49,142,15
CHEMBL4616_EC50,GCN,Canonical,0,0.74102334,0.84808952,669,348,527,273,142,75
CHEMBL4616_EC50,MPNN,Canonical,0,0.87307517,0.90136108,669,348,527,273,142,75
CHEMBL4616_EC50,GAT,Canonical,0,1.09512332,1.08724393,669,348,527,273,142,75
CHEMBL4792_Ki,GCN,Canonical,0,0.82197487,0.89168521,1471,783,1166,624,305,159
CHEMBL4792_Ki,MPNN,Canonical,0,1.09864285,1.13028318,1471,783,1166,624,305,159
CHEMBL4792_Ki,GAT,Canonical,0,1.16290239,1.15942246,1471,783,1166,624,305,159
CHEMBL1862_Ki,RF,ECFP,0,0.785197699,0.724873809,790,329,630,261,160,68
CHEMBL1862_Ki,GBM,ECFP,0,0.800541958,0.735106317,790,329,630,261,160,68
CHEMBL1862_Ki,SVM,ECFP,0,0.751250722,0.749207601,790,329,630,261,160,68
CHEMBL1862_Ki,KNN,ECFP,0,0.865658748,0.791887788,790,329,630,261,160,68
CHEMBL1862_Ki,MLP,ECFP,0,0.786012506,0.737126674,790,329,630,261,160,68
CHEMBL1871_Ki,RF,ECFP,0,0.598172911,0.781876538,647,133,512,103,135,30
CHEMBL1871_Ki,GBM,ECFP,0,0.637032468,0.812262564,647,133,512,103,135,30
CHEMBL1871_Ki,SVM,ECFP,0,0.627763368,0.765799668,647,133,512,103,135,30
CHEMBL1871_Ki,KNN,ECFP,0,0.609738081,0.784674008,647,133,512,103,135,30
CHEMBL1871_Ki,MLP,ECFP,0,0.647598074,0.822194883,647,133,512,103,135,30
CHEMBL2034_Ki,RF,ECFP,0,0.698766513,0.862742219,750,245,592,191,158,54
CHEMBL2034_Ki,GBM,ECFP,0,0.69603541,0.868219259,750,245,592,191,158,54
CHEMBL2034_Ki,SVM,ECFP,0,0.654550562,0.821772164,750,245,592,191,158,54
CHEMBL2034_Ki,KNN,ECFP,0,0.743861605,0.916745188,750,245,592,191,158,54
CHEMBL2034_Ki,MLP,ECFP,0,0.664863439,0.827877955,750,245,592,191,158,54
CHEMBL204_Ki,RF,ECFP,0,0.738278288,0.893390745,2733,1060,2161,829,572,231
CHEMBL204_Ki,GBM,ECFP,0,0.723883293,0.869180359,2733,1060,2161,829,572,231
CHEMBL204_Ki,SVM,ECFP,0,0.699820015,0.821230848,2733,1060,2161,829,572,231
CHEMBL204_Ki,KNN,ECFP,0,0.781698624,0.981036406,2733,1060,2161,829,572,231
CHEMBL204_Ki,MLP,ECFP,0,0.721238365,0.834948086,2733,1060,2161,829,572,231
CHEMBL2047_EC50,RF,ECFP,0,0.560746186,0.723064335,631,245,498,197,133,48
CHEMBL2047_EC50,GBM,ECFP,0,0.586529065,0.738589061,631,245,498,197,133,48
CHEMBL2047_EC50,SVM,ECFP,0,0.584029007,0.752788226,631,245,498,197,133,48
CHEMBL2047_EC50,KNN,ECFP,0,0.603730105,0.777927429,631,245,498,197,133,48
CHEMBL2047_EC50,MLP,ECFP,0,0.639676587,0.782095036,631,245,498,197,133,48
CHEMBL214_Ki,RF,ECFP,0,0.637813054,0.718654138,3261,1161,2590,920,671,241
CHEMBL214_Ki,GBM,ECFP,0,0.640435799,0.725327681,3261,1161,2590,920,671,241
CHEMBL214_Ki,SVM,ECFP,0,0.618143494,0.682494307,3261,1161,2590,920,671,241
CHEMBL214_Ki,KNN,ECFP,0,0.677037828,0.766119204,3261,1161,2590,920,671,241
CHEMBL214_Ki,MLP,ECFP,0,0.631386383,0.707574133,3261,1161,2590,920,671,241
CHEMBL2147_Ki,RF,ECFP,0,0.706295574,0.702493606,1456,560,1163,449,293,111
CHEMBL2147_Ki,GBM,ECFP,0,0.695232319,0.683706865,1456,560,1163,449,293,111
CHEMBL2147_Ki,SVM,ECFP,0,0.690573751,0.67407498,1456,560,1163,449,293,111
CHEMBL2147_Ki,KNN,ECFP,0,0.798602867,0.798418999,1456,560,1163,449,293,111
CHEMBL2147_Ki,MLP,ECFP,0,0.703154446,0.667443678,1456,560,1163,449,293,111
CHEMBL218_EC50,RF,ECFP,0,0.613509787,0.749496813,1009,335,804,263,205,72
CHEMBL218_EC50,GBM,ECFP,0,0.622251113,0.771375814,1009,335,804,263,205,72
CHEMBL218_EC50,SVM,ECFP,0,0.618661226,0.721482566,1009,335,804,263,205,72
CHEMBL218_EC50,KNN,ECFP,0,0.605233072,0.785059895,1009,335,804,263,205,72
CHEMBL218_EC50,MLP,ECFP,0,0.612528827,0.736181454,1009,335,804,263,205,72
CHEMBL219_Ki,RF,ECFP,0,0.69481338,0.729451005,1834,700,1448,554,386,146
CHEMBL219_Ki,GBM,ECFP,0,0.715952435,0.715866179,1834,700,1448,554,386,146
CHEMBL219_Ki,SVM,ECFP,0,0.684896025,0.701612158,1834,700,1448,554,386,146
CHEMBL219_Ki,KNN,ECFP,0,0.779622382,0.800282171,1834,700,1448,554,386,146
CHEMBL219_Ki,MLP,ECFP,0,0.68559333,0.709206994,1834,700,1448,554,386,146
CHEMBL228_Ki,RF,ECFP,0,0.651706346,0.742551697,1681,614,1332,484,349,130
CHEMBL228_Ki,GBM,ECFP,0,0.671617231,0.730779886,1681,614,1332,484,349,130
CHEMBL228_Ki,SVM,ECFP,0,0.633907017,0.72149168,1681,614,1332,484,349,130
CHEMBL228_Ki,KNN,ECFP,0,0.708878878,0.809457075,1681,614,1332,484,349,130
CHEMBL228_Ki,MLP,ECFP,0,0.637180264,0.722962839,1681,614,1332,484,349,130
CHEMBL231_Ki,RF,ECFP,0,0.646264697,0.721269731,967,231,769,180,198,51
CHEMBL231_Ki,GBM,ECFP,0,0.623111567,0.735259579,967,231,769,180,198,51
CHEMBL231_Ki,SVM,ECFP,0,0.632543963,0.800273075,967,231,769,180,198,51
CHEMBL231_Ki,KNN,ECFP,0,0.654354889,0.833803136,967,231,769,180,198,51
CHEMBL231_Ki,MLP,ECFP,0,0.643678974,0.761256383,967,231,769,180,198,51
CHEMBL233_Ki,RF,ECFP,0,0.713981409,0.820705136,3062,1215,2433,957,629,258
CHEMBL233_Ki,GBM,ECFP,0,0.735185266,0.833134506,3062,1215,2433,957,629,258
CHEMBL233_Ki,SVM,ECFP,0,0.718980324,0.807725763,3062,1215,2433,957,629,258
CHEMBL233_Ki,KNN,ECFP,0,0.760534186,0.829895766,3062,1215,2433,957,629,258
CHEMBL233_Ki,MLP,ECFP,0,0.732366845,0.801099895,3062,1215,2433,957,629,258
CHEMBL234_Ki,RF,ECFP,0,0.636897415,0.640567137,3619,1569,2876,1227,743,342
CHEMBL234_Ki,GBM,ECFP,0,0.652715531,0.653912227,3619,1569,2876,1227,743,342
CHEMBL234_Ki,SVM,ECFP,0,0.634740986,0.604604411,3619,1569,2876,1227,743,342
CHEMBL234_Ki,KNN,ECFP,0,0.692713574,0.686951986,3619,1569,2876,1227,743,342
CHEMBL234_Ki,MLP,ECFP,0,0.62927077,0.60906379,3619,1569,2876,1227,743,342
CHEMBL235_EC50,RF,ECFP,0,0.675219337,0.871745078,2325,864,1857,689,468,175
CHEMBL235_EC50,GBM,ECFP,0,0.685962946,0.874409042,2325,864,1857,689,468,175
CHEMBL235_EC50,SVM,ECFP,0,0.679693236,0.858970939,2325,864,1857,689,468,175
CHEMBL235_EC50,KNN,ECFP,0,0.705697414,0.920025905,2325,864,1857,689,468,175
CHEMBL235_EC50,MLP,ECFP,0,0.67396979,0.846161642,2325,864,1857,689,468,175
CHEMBL236_Ki,RF,ECFP,0,0.633099987,0.704773152,2547,983,2033,784,514,199
CHEMBL236_Ki,GBM,ECFP,0,0.651057364,0.734879301,2547,983,2033,784,514,199
CHEMBL236_Ki,SVM,ECFP,0,0.659183021,0.723962184,2547,983,2033,784,514,199
CHEMBL236_Ki,KNN,ECFP,0,0.680659737,0.787031898,2547,983,2033,784,514,199
CHEMBL236_Ki,MLP,ECFP,0,0.647192254,0.715990438,2547,983,2033,784,514,199
CHEMBL237_EC50,RF,ECFP,0,0.76863594,0.812170459,939,444,744,350,195,94
CHEMBL237_EC50,GBM,ECFP,0,0.791644152,0.843500245,939,444,744,350,195,94
CHEMBL237_EC50,SVM,ECFP,0,0.794534858,0.819619233,939,444,744,350,195,94
CHEMBL237_EC50,KNN,ECFP,0,0.854804394,0.907810805,939,444,744,350,195,94
CHEMBL237_EC50,MLP,ECFP,0,0.806488917,0.812508387,939,444,744,350,195,94
CHEMBL237_Ki,RF,ECFP,0,0.705563658,0.752781138,2547,1070,2020,844,527,226
CHEMBL237_Ki,GBM,ECFP,0,0.732230366,0.802227221,2547,1070,2020,844,527,226
CHEMBL237_Ki,SVM,ECFP,0,0.711663012,0.714959983,2547,1070,2020,844,527,226
CHEMBL237_Ki,KNN,ECFP,0,0.756686491,0.809015427,2547,1070,2020,844,527,226
CHEMBL237_Ki,MLP,ECFP,0,0.7248103,0.733058109,2547,1070,2020,844,527,226
CHEMBL238_Ki,RF,ECFP,0,0.596313587,0.671311418,1041,255,830,208,211,47
CHEMBL238_Ki,GBM,ECFP,0,0.579750755,0.623980962,1041,255,830,208,211,47
CHEMBL238_Ki,SVM,ECFP,0,0.585524737,0.681687018,1041,255,830,208,211,47
CHEMBL238_Ki,KNN,ECFP,0,0.588297855,0.656390086,1041,255,830,208,211,47
CHEMBL238_Ki,MLP,ECFP,0,0.60024561,0.64740382,1041,255,830,208,211,47
CHEMBL239_EC50,RF,ECFP,0,0.696764341,0.855516378,1709,692,1357,541,352,151
CHEMBL239_EC50,GBM,ECFP,0,0.683383747,0.828595343,1709,692,1357,541,352,151
CHEMBL239_EC50,SVM,ECFP,0,0.678377382,0.829440826,1709,692,1357,541,352,151
CHEMBL239_EC50,KNN,ECFP,0,0.741987543,0.90486368,1709,692,1357,541,352,151
CHEMBL239_EC50,MLP,ECFP,0,0.7009415,0.852173426,1709,692,1357,541,352,151
CHEMBL244_Ki,RF,ECFP,0,0.766605971,0.857063476,3082,1447,2439,1154,643,293
CHEMBL244_Ki,GBM,ECFP,0,0.773065129,0.840544023,3082,1447,2439,1154,643,293
CHEMBL244_Ki,SVM,ECFP,0,0.747077233,0.8255565,3082,1447,2439,1154,643,293
CHEMBL244_Ki,KNN,ECFP,0,0.822412143,0.92106051,3082,1447,2439,1154,643,293
CHEMBL244_Ki,MLP,ECFP,0,0.751335366,0.846758987,3082,1447,2439,1154,643,293
CHEMBL262_Ki,RF,ECFP,0,0.731231662,0.833513846,856,164,685,126,171,38
CHEMBL262_Ki,GBM,ECFP,0,0.752905188,0.840485495,856,164,685,126,171,38
CHEMBL262_Ki,SVM,ECFP,0,0.700887505,0.833837507,856,164,685,126,171,38
CHEMBL262_Ki,KNN,ECFP,0,0.81311668,0.97472722,856,164,685,126,171,38
CHEMBL262_Ki,MLP,ECFP,0,0.74277046,0.875508358,856,164,685,126,171,38
CHEMBL264_Ki,RF,ECFP,0,0.610948215,0.689061607,2753,1092,2185,868,568,224
CHEMBL264_Ki,GBM,ECFP,0,0.621207935,0.672562815,2753,1092,2185,868,568,224
CHEMBL264_Ki,SVM,ECFP,0,0.597891756,0.631845208,2753,1092,2185,868,568,224
CHEMBL264_Ki,KNN,ECFP,0,0.703369695,0.786818039,2753,1092,2185,868,568,224
CHEMBL264_Ki,MLP,ECFP,0,0.613278462,0.645158486,2753,1092,2185,868,568,224
CHEMBL2835_Ki,RF,ECFP,0,0.41976207,0.655638824,609,54,485,43,124,11
CHEMBL2835_Ki,GBM,ECFP,0,0.426362355,0.720966345,609,54,485,43,124,11
CHEMBL2835_Ki,SVM,ECFP,0,0.408070118,0.64289134,609,54,485,43,124,11
CHEMBL2835_Ki,KNN,ECFP,0,0.42176682,0.614897828,609,54,485,43,124,11
CHEMBL2835_Ki,MLP,ECFP,0,0.432295863,0.675860052,609,54,485,43,124,11
CHEMBL287_Ki,RF,ECFP,0,0.777172679,0.936238448,1243,427,987,335,256,92
CHEMBL287_Ki,GBM,ECFP,0,0.772054917,0.95771297,1243,427,987,335,256,92
CHEMBL287_Ki,SVM,ECFP,0,0.729812022,0.926322474,1243,427,987,335,256,92
CHEMBL287_Ki,KNN,ECFP,0,0.839303509,0.96687058,1243,427,987,335,256,92
CHEMBL287_Ki,MLP,ECFP,0,0.74619168,0.943231753,1243,427,987,335,256,92
CHEMBL2971_Ki,RF,ECFP,0,0.646357244,0.808485355,973,150,776,117,197,33
CHEMBL2971_Ki,GBM,ECFP,0,0.64632352,0.756724238,973,150,776,117,197,33
CHEMBL2971_Ki,SVM,ECFP,0,0.6070071,0.691575307,973,150,776,117,197,33
CHEMBL2971_Ki,KNN,ECFP,0,0.661168566,0.93244668,973,150,776,117,197,33
CHEMBL2971_Ki,MLP,ECFP,0,0.656919247,0.719839033,973,150,776,117,197,33
CHEMBL3979_EC50,RF,ECFP,0,0.600905898,0.740498424,1116,451,885,355,231,96
CHEMBL3979_EC50,GBM,ECFP,0,0.584125076,0.699541824,1116,451,885,355,231,96
CHEMBL3979_EC50,SVM,ECFP,0,0.5889781,0.706049668,1116,451,885,355,231,96
CHEMBL3979_EC50,KNN,ECFP,0,0.607914479,0.763575448,1116,451,885,355,231,96
CHEMBL3979_EC50,MLP,ECFP,0,0.612263978,0.74595478,1116,451,885,355,231,96
CHEMBL4005_Ki,RF,ECFP,0,0.619003663,0.731505011,960,386,761,307,199,79
CHEMBL4005_Ki,GBM,ECFP,0,0.622688155,0.720496515,960,386,761,307,199,79
CHEMBL4005_Ki,SVM,ECFP,0,0.589533117,0.688319262,960,386,761,307,199,79
CHEMBL4005_Ki,KNN,ECFP,0,0.643510164,0.802818927,960,386,761,307,199,79
CHEMBL4005_Ki,MLP,ECFP,0,0.601741591,0.682932699,960,386,761,307,199,79
CHEMBL4203_Ki,RF,ECFP,0,0.677196731,0.818666074,731,64,589,49,142,15
CHEMBL4203_Ki,GBM,ECFP,0,0.702729719,0.840872059,731,64,589,49,142,15
CHEMBL4203_Ki,SVM,ECFP,0,0.681989481,0.797460265,731,64,589,49,142,15
CHEMBL4203_Ki,KNN,ECFP,0,0.75116473,0.76409271,731,64,589,49,142,15
CHEMBL4203_Ki,MLP,ECFP,0,0.697299571,0.774846398,731,64,589,49,142,15
CHEMBL4616_EC50,RF,ECFP,0,0.638044615,0.723227285,669,348,527,273,142,75
CHEMBL4616_EC50,GBM,ECFP,0,0.692332112,0.790706553,669,348,527,273,142,75
CHEMBL4616_EC50,SVM,ECFP,0,0.658705325,0.734096528,669,348,527,273,142,75
CHEMBL4616_EC50,KNN,ECFP,0,0.671463533,0.77129062,669,348,527,273,142,75
CHEMBL4616_EC50,MLP,ECFP,0,0.679166833,0.719229626,669,348,527,273,142,75
CHEMBL4792_Ki,RF,ECFP,0,0.64339734,0.736141511,1471,783,1166,624,305,159
CHEMBL4792_Ki,GBM,ECFP,0,0.624794658,0.729606489,1471,783,1166,624,305,159
CHEMBL4792_Ki,SVM,ECFP,0,0.61864181,0.710205399,1471,783,1166,624,305,159
CHEMBL4792_Ki,KNN,ECFP,0,0.739714487,0.843707237,1471,783,1166,624,305,159
CHEMBL4792_Ki,MLP,ECFP,0,0.644772399,0.740195816,1471,783,1166,624,305,159
CHEMBL1862_Ki,RF,MACCs,0,0.84487255,0.818416791,790,329,630,261,160,68
CHEMBL1862_Ki,GBM,MACCs,0,0.822113321,0.798593857,790,329,630,261,160,68
CHEMBL1862_Ki,SVM,MACCs,0,0.929941199,0.908835505,790,329,630,261,160,68
CHEMBL1862_Ki,KNN,MACCs,0,1.05756078,0.918641767,790,329,630,261,160,68
CHEMBL1871_Ki,RF,MACCs,0,0.654787346,0.749559753,647,133,512,103,135,30
CHEMBL1871_Ki,GBM,MACCs,0,0.661798374,0.70404628,647,133,512,103,135,30
CHEMBL1871_Ki,SVM,MACCs,0,0.685096169,0.794219808,647,133,512,103,135,30
CHEMBL1871_Ki,KNN,MACCs,0,0.69070988,0.767204217,647,133,512,103,135,30
CHEMBL2034_Ki,RF,MACCs,0,0.761795101,0.925271727,750,245,592,191,158,54
CHEMBL2034_Ki,GBM,MACCs,0,0.764829235,0.897899171,750,245,592,191,158,54
CHEMBL2034_Ki,SVM,MACCs,0,0.802982449,1.002691714,750,245,592,191,158,54
CHEMBL2034_Ki,KNN,MACCs,0,0.825001992,1.011507862,750,245,592,191,158,54
CHEMBL204_Ki,RF,MACCs,0,0.799191295,0.902638768,2733,1060,2161,829,572,231
CHEMBL204_Ki,GBM,MACCs,0,0.791302411,0.88928012,2733,1060,2161,829,572,231
CHEMBL204_Ki,SVM,MACCs,0,0.784319497,0.881524062,2733,1060,2161,829,572,231
CHEMBL204_Ki,KNN,MACCs,0,0.864607396,0.962947569,2733,1060,2161,829,572,231
CHEMBL2047_EC50,RF,MACCs,0,0.607438915,0.761548985,631,245,498,197,133,48
CHEMBL2047_EC50,GBM,MACCs,0,0.605756955,0.779815876,631,245,498,197,133,48
CHEMBL2047_EC50,SVM,MACCs,0,0.656660731,0.760152025,631,245,498,197,133,48
CHEMBL2047_EC50,KNN,MACCs,0,0.676334756,0.866896916,631,245,498,197,133,48
CHEMBL214_Ki,RF,MACCs,0,0.715732098,0.810971324,3261,1161,2590,920,671,241
CHEMBL214_Ki,GBM,MACCs,0,0.73173733,0.816192877,3261,1161,2590,920,671,241
CHEMBL214_Ki,SVM,MACCs,0,0.721108763,0.792926779,3261,1161,2590,920,671,241
CHEMBL214_Ki,KNN,MACCs,0,0.756271566,0.82889417,3261,1161,2590,920,671,241
CHEMBL2147_Ki,RF,MACCs,0,0.83476297,0.875559082,1456,560,1163,449,293,111
CHEMBL2147_Ki,GBM,MACCs,0,0.826941039,0.825090226,1456,560,1163,449,293,111
CHEMBL2147_Ki,SVM,MACCs,0,0.831710508,0.842762513,1456,560,1163,449,293,111
CHEMBL2147_Ki,KNN,MACCs,0,0.970173951,0.940227183,1456,560,1163,449,293,111
CHEMBL218_EC50,RF,MACCs,0,0.648571498,0.759367446,1009,335,804,263,205,72
CHEMBL218_EC50,GBM,MACCs,0,0.635468873,0.744878103,1009,335,804,263,205,72
CHEMBL218_EC50,SVM,MACCs,0,0.683967545,0.807390908,1009,335,804,263,205,72
CHEMBL218_EC50,KNN,MACCs,0,0.669405768,0.783323952,1009,335,804,263,205,72
CHEMBL219_Ki,RF,MACCs,0,0.760208356,0.808765955,1834,700,1448,554,386,146
CHEMBL219_Ki,GBM,MACCs,0,0.75067164,0.773769006,1834,700,1448,554,386,146
CHEMBL219_Ki,SVM,MACCs,0,0.740312218,0.782584403,1834,700,1448,554,386,146
CHEMBL219_Ki,KNN,MACCs,0,0.829982957,0.914105392,1834,700,1448,554,386,146
CHEMBL228_Ki,RF,MACCs,0,0.684957969,0.729535957,1681,614,1332,484,349,130
CHEMBL228_Ki,GBM,MACCs,0,0.680127419,0.746039524,1681,614,1332,484,349,130
CHEMBL228_Ki,SVM,MACCs,0,0.708692923,0.772128159,1681,614,1332,484,349,130
CHEMBL228_Ki,KNN,MACCs,0,0.749649132,0.784705209,1681,614,1332,484,349,130
CHEMBL231_Ki,RF,MACCs,0,0.681136992,0.723355172,967,231,769,180,198,51
CHEMBL231_Ki,GBM,MACCs,0,0.683247226,0.708851292,967,231,769,180,198,51
CHEMBL231_Ki,SVM,MACCs,0,0.684667325,0.767600151,967,231,769,180,198,51
CHEMBL231_Ki,KNN,MACCs,0,0.742687483,0.74887733,967,231,769,180,198,51
CHEMBL233_Ki,RF,MACCs,0,0.788574533,0.912811883,3062,1215,2433,957,629,258
CHEMBL233_Ki,GBM,MACCs,0,0.78183313,0.879136135,3062,1215,2433,957,629,258
CHEMBL233_Ki,SVM,MACCs,0,0.787327796,0.889096571,3062,1215,2433,957,629,258
CHEMBL233_Ki,KNN,MACCs,0,0.842954744,0.945234027,3062,1215,2433,957,629,258
CHEMBL234_Ki,RF,MACCs,0,0.731739105,0.740122464,3619,1569,2876,1227,743,342
CHEMBL234_Ki,GBM,MACCs,0,0.725660845,0.704851441,3619,1569,2876,1227,743,342
CHEMBL234_Ki,SVM,MACCs,0,0.70936715,0.692174879,3619,1569,2876,1227,743,342
CHEMBL234_Ki,KNN,MACCs,0,0.810546325,0.80046352,3619,1569,2876,1227,743,342
CHEMBL235_EC50,RF,MACCs,0,0.718937384,0.92360033,2325,864,1857,689,468,175
CHEMBL235_EC50,GBM,MACCs,0,0.741069721,0.938834398,2325,864,1857,689,468,175
CHEMBL235_EC50,SVM,MACCs,0,0.728822585,0.950889657,2325,864,1857,689,468,175
CHEMBL235_EC50,KNN,MACCs,0,0.778148707,0.977269634,2325,864,1857,689,468,175
CHEMBL236_Ki,RF,MACCs,0,0.748376704,0.849731968,2547,983,2033,784,514,199
CHEMBL236_Ki,GBM,MACCs,0,0.74970327,0.850836257,2547,983,2033,784,514,199
CHEMBL236_Ki,SVM,MACCs,0,0.759237377,0.826309823,2547,983,2033,784,514,199
CHEMBL236_Ki,KNN,MACCs,0,0.831996441,0.870946319,2547,983,2033,784,514,199
CHEMBL237_EC50,RF,MACCs,0,0.899365303,0.908371532,939,444,744,350,195,94
CHEMBL237_EC50,GBM,MACCs,0,0.903843535,0.912455888,939,444,744,350,195,94
CHEMBL237_EC50,SVM,MACCs,0,0.874590154,0.89119216,939,444,744,350,195,94
CHEMBL237_EC50,KNN,MACCs,0,1.019907054,1.017817589,939,444,744,350,195,94
CHEMBL237_Ki,RF,MACCs,0,0.768381371,0.844494227,2547,1070,2020,844,527,226
CHEMBL237_Ki,GBM,MACCs,0,0.787005514,0.85854607,2547,1070,2020,844,527,226
CHEMBL237_Ki,SVM,MACCs,0,0.781908477,0.830161085,2547,1070,2020,844,527,226
CHEMBL237_Ki,KNN,MACCs,0,0.84197257,0.90390414,2547,1070,2020,844,527,226
CHEMBL238_Ki,RF,MACCs,0,0.584988802,0.662285076,1041,255,830,208,211,47
CHEMBL238_Ki,GBM,MACCs,0,0.60173369,0.663371602,1041,255,830,208,211,47
CHEMBL238_Ki,SVM,MACCs,0,0.584623713,0.623018329,1041,255,830,208,211,47
CHEMBL238_Ki,KNN,MACCs,0,0.646812608,0.751381602,1041,255,830,208,211,47
CHEMBL239_EC50,RF,MACCs,0,0.736637546,0.903048403,1709,692,1357,541,352,151
CHEMBL239_EC50,GBM,MACCs,0,0.745028881,0.877433226,1709,692,1357,541,352,151
CHEMBL239_EC50,SVM,MACCs,0,0.748090652,0.920621877,1709,692,1357,541,352,151
CHEMBL239_EC50,KNN,MACCs,0,0.781222798,0.961269982,1709,692,1357,541,352,151
CHEMBL244_Ki,RF,MACCs,0,0.832427184,0.932107933,3082,1447,2439,1154,643,293
CHEMBL244_Ki,GBM,MACCs,0,0.814601041,0.93259333,3082,1447,2439,1154,643,293
CHEMBL244_Ki,SVM,MACCs,0,0.842871858,0.960293934,3082,1447,2439,1154,643,293
CHEMBL244_Ki,KNN,MACCs,0,0.900248791,0.990159692,3082,1447,2439,1154,643,293
CHEMBL262_Ki,RF,MACCs,0,0.789062779,0.876809839,856,164,685,126,171,38
CHEMBL262_Ki,GBM,MACCs,0,0.809893092,0.908512222,856,164,685,126,171,38
CHEMBL262_Ki,SVM,MACCs,0,0.807762754,0.997627351,856,164,685,126,171,38
CHEMBL262_Ki,KNN,MACCs,0,0.873700712,0.943529566,856,164,685,126,171,38
CHEMBL264_Ki,RF,MACCs,0,0.704975493,0.788281376,2753,1092,2185,868,568,224
CHEMBL264_Ki,GBM,MACCs,0,0.691198565,0.784371258,2753,1092,2185,868,568,224
CHEMBL264_Ki,SVM,MACCs,0,0.699814733,0.788608908,2753,1092,2185,868,568,224
CHEMBL264_Ki,KNN,MACCs,0,0.749807827,0.844273556,2753,1092,2185,868,568,224
CHEMBL2835_Ki,RF,MACCs,0,0.460593076,0.64742593,609,54,485,43,124,11
CHEMBL2835_Ki,GBM,MACCs,0,0.430505199,0.613077412,609,54,485,43,124,11
CHEMBL2835_Ki,SVM,MACCs,0,0.484287287,0.664929286,609,54,485,43,124,11
CHEMBL2835_Ki,KNN,MACCs,0,0.443689173,0.481211858,609,54,485,43,124,11
CHEMBL287_Ki,RF,MACCs,0,0.774574038,0.939876269,1243,427,987,335,256,92
CHEMBL287_Ki,GBM,MACCs,0,0.745503131,0.934731483,1243,427,987,335,256,92
CHEMBL287_Ki,SVM,MACCs,0,0.763147006,0.91874741,1243,427,987,335,256,92
CHEMBL287_Ki,KNN,MACCs,0,0.855085153,0.977672585,1243,427,987,335,256,92
CHEMBL2971_Ki,RF,MACCs,0,0.694876284,0.765353548,973,150,776,117,197,33
CHEMBL2971_Ki,GBM,MACCs,0,0.685819714,0.731579657,973,150,776,117,197,33
CHEMBL2971_Ki,SVM,MACCs,0,0.689751011,0.74861085,973,150,776,117,197,33
CHEMBL2971_Ki,KNN,MACCs,0,0.814229534,0.835990267,973,150,776,117,197,33
CHEMBL3979_EC50,RF,MACCs,0,0.648518222,0.774828864,1116,451,885,355,231,96
CHEMBL3979_EC50,GBM,MACCs,0,0.629631713,0.746993553,1116,451,885,355,231,96
CHEMBL3979_EC50,SVM,MACCs,0,0.624688653,0.774160748,1116,451,885,355,231,96
CHEMBL3979_EC50,KNN,MACCs,0,0.674923235,0.802423516,1116,451,885,355,231,96
CHEMBL4005_Ki,RF,MACCs,0,0.697586476,0.80865156,960,386,761,307,199,79
CHEMBL4005_Ki,GBM,MACCs,0,0.688793207,0.797074435,960,386,761,307,199,79
CHEMBL4005_Ki,SVM,MACCs,0,0.723903672,0.803628027,960,386,761,307,199,79
CHEMBL4005_Ki,KNN,MACCs,0,0.787964467,0.888903145,960,386,761,307,199,79
CHEMBL4203_Ki,RF,MACCs,0,0.783964478,1.134253039,731,64,589,49,142,15
CHEMBL4203_Ki,GBM,MACCs,0,0.769800287,1.087719625,731,64,589,49,142,15
CHEMBL4203_Ki,SVM,MACCs,0,0.78102965,1.113814766,731,64,589,49,142,15
CHEMBL4203_Ki,KNN,MACCs,0,0.847676722,1.065986963,731,64,589,49,142,15
CHEMBL4616_EC50,RF,MACCs,0,0.666502702,0.767956655,669,348,527,273,142,75
CHEMBL4616_EC50,GBM,MACCs,0,0.676161478,0.770402148,669,348,527,273,142,75
CHEMBL4616_EC50,SVM,MACCs,0,0.683944764,0.754651153,669,348,527,273,142,75
CHEMBL4616_EC50,KNN,MACCs,0,0.716008208,0.802976993,669,348,527,273,142,75
CHEMBL4792_Ki,RF,MACCs,0,0.739356734,0.839139968,1471,783,1166,624,305,159
CHEMBL4792_Ki,GBM,MACCs,0,0.762571419,0.861753677,1471,783,1166,624,305,159
CHEMBL4792_Ki,SVM,MACCs,0,0.760060751,0.821193149,1471,783,1166,624,305,159
CHEMBL4792_Ki,KNN,MACCs,0,0.803417487,0.863920804,1471,783,1166,624,305,159
CHEMBL1862_Ki,RF,Physchem,0,0.90765991,0.834567948,790,329,630,261,160,68
CHEMBL1862_Ki,GBM,Physchem,0,0.926139849,0.856403818,790,329,630,261,160,68
CHEMBL1862_Ki,SVM,Physchem,0,0.937397048,0.803369358,790,329,630,261,160,68
CHEMBL1862_Ki,KNN,Physchem,0,0.9450658,0.931850465,790,329,630,261,160,68
CHEMBL1871_Ki,RF,Physchem,0,0.722164665,0.919315203,647,133,512,103,135,30
CHEMBL1871_Ki,GBM,Physchem,0,0.74805924,0.967540488,647,133,512,103,135,30
CHEMBL1871_Ki,SVM,Physchem,0,0.817546579,0.829340412,647,133,512,103,135,30
CHEMBL1871_Ki,KNN,Physchem,0,0.724485208,0.882116662,647,133,512,103,135,30
CHEMBL2034_Ki,RF,Physchem,0,0.738847476,0.946092892,750,245,592,191,158,54
CHEMBL2034_Ki,GBM,Physchem,0,0.762286885,1.009283387,750,245,592,191,158,54
CHEMBL2034_Ki,SVM,Physchem,0,0.805248776,1.040140013,750,245,592,191,158,54
CHEMBL2034_Ki,KNN,Physchem,0,0.861399156,1.01613989,750,245,592,191,158,54
CHEMBL204_Ki,RF,Physchem,0,1.130765598,1.164188688,2733,1060,2161,829,572,231
CHEMBL204_Ki,GBM,Physchem,0,1.164979456,1.242207988,2733,1060,2161,829,572,231
CHEMBL204_Ki,SVM,Physchem,0,1.200385265,1.229857036,2733,1060,2161,829,572,231
CHEMBL204_Ki,KNN,Physchem,0,1.144413963,1.199420377,2733,1060,2161,829,572,231
CHEMBL2047_EC50,RF,Physchem,0,0.736462864,0.862393068,631,245,498,197,133,48
CHEMBL2047_EC50,GBM,Physchem,0,0.751780472,0.864006784,631,245,498,197,133,48
CHEMBL2047_EC50,SVM,Physchem,0,0.738042141,0.884892886,631,245,498,197,133,48
CHEMBL2047_EC50,KNN,Physchem,0,0.718388878,0.839072263,631,245,498,197,133,48
CHEMBL214_Ki,RF,Physchem,0,0.879366108,0.916849093,3261,1161,2590,920,671,241
CHEMBL214_Ki,GBM,Physchem,0,0.862365497,0.927124273,3261,1161,2590,920,671,241
CHEMBL214_Ki,SVM,Physchem,0,0.924059473,0.971050856,3261,1161,2590,920,671,241
CHEMBL214_Ki,KNN,Physchem,0,0.914781668,0.93167405,3261,1161,2590,920,671,241
CHEMBL2147_Ki,RF,Physchem,0,0.984782962,0.937959568,1456,560,1163,449,293,111
CHEMBL2147_Ki,GBM,Physchem,0,0.977627975,0.89454677,1456,560,1163,449,293,111
CHEMBL2147_Ki,SVM,Physchem,0,1.024402743,0.92403461,1456,560,1163,449,293,111
CHEMBL2147_Ki,KNN,Physchem,0,1.042524115,1.007930171,1456,560,1163,449,293,111
CHEMBL218_EC50,RF,Physchem,0,0.760089382,0.782128649,1009,335,804,263,205,72
CHEMBL218_EC50,GBM,Physchem,0,0.778415216,0.786374028,1009,335,804,263,205,72
CHEMBL218_EC50,SVM,Physchem,0,0.796597747,0.890058567,1009,335,804,263,205,72
CHEMBL218_EC50,KNN,Physchem,0,0.751403944,0.763007027,1009,335,804,263,205,72
CHEMBL219_Ki,RF,Physchem,0,0.830266774,0.8423179,1834,700,1448,554,386,146
CHEMBL219_Ki,GBM,Physchem,0,0.861914607,0.856414652,1834,700,1448,554,386,146
CHEMBL219_Ki,SVM,Physchem,0,0.864217161,0.88889963,1834,700,1448,554,386,146
CHEMBL219_Ki,KNN,Physchem,0,0.882804717,0.918841471,1834,700,1448,554,386,146
CHEMBL228_Ki,RF,Physchem,0,0.829327497,0.848463746,1681,614,1332,484,349,130
CHEMBL228_Ki,GBM,Physchem,0,0.833311559,0.845082558,1681,614,1332,484,349,130
CHEMBL228_Ki,SVM,Physchem,0,0.876282079,0.830496962,1681,614,1332,484,349,130
CHEMBL228_Ki,KNN,Physchem,0,0.902320582,0.925166568,1681,614,1332,484,349,130
CHEMBL231_Ki,RF,Physchem,0,0.833504406,0.854622142,967,231,769,180,198,51
CHEMBL231_Ki,GBM,Physchem,0,0.867261696,0.952169258,967,231,769,180,198,51
CHEMBL231_Ki,SVM,Physchem,0,0.939185133,0.984528663,967,231,769,180,198,51
CHEMBL231_Ki,KNN,Physchem,0,0.893329894,0.90586396,967,231,769,180,198,51
CHEMBL233_Ki,RF,Physchem,0,0.946152765,0.979149508,3062,1215,2433,957,629,258
CHEMBL233_Ki,GBM,Physchem,0,0.972828271,1.007452335,3062,1215,2433,957,629,258
CHEMBL233_Ki,SVM,Physchem,0,1.03461243,1.129836748,3062,1215,2433,957,629,258
CHEMBL233_Ki,KNN,Physchem,0,1.000826037,1.018345289,3062,1215,2433,957,629,258
CHEMBL234_Ki,RF,Physchem,0,0.867077364,0.854048235,3619,1569,2876,1227,743,342
CHEMBL234_Ki,GBM,Physchem,0,0.867026777,0.846270267,3619,1569,2876,1227,743,342
CHEMBL234_Ki,SVM,Physchem,0,0.913652003,0.869878101,3619,1569,2876,1227,743,342
CHEMBL234_Ki,KNN,Physchem,0,0.897771416,0.855540618,3619,1569,2876,1227,743,342
CHEMBL235_EC50,RF,Physchem,0,0.806332414,0.905123511,2325,864,1857,689,468,175
CHEMBL235_EC50,GBM,Physchem,0,0.821209309,0.919106825,2325,864,1857,689,468,175
CHEMBL235_EC50,SVM,Physchem,0,0.917913907,1.038534091,2325,864,1857,689,468,175
CHEMBL235_EC50,KNN,Physchem,0,0.872874701,0.945617282,2325,864,1857,689,468,175
CHEMBL236_Ki,RF,Physchem,0,0.941941046,0.985879113,2547,983,2033,784,514,199
CHEMBL236_Ki,GBM,Physchem,0,0.970286393,1.019872415,2547,983,2033,784,514,199
CHEMBL236_Ki,SVM,Physchem,0,1.09467824,1.17076842,2547,983,2033,784,514,199
CHEMBL236_Ki,KNN,Physchem,0,0.993672134,1.041622528,2547,983,2033,784,514,199
CHEMBL237_EC50,RF,Physchem,0,1.037711511,1.095303978,939,444,744,350,195,94
CHEMBL237_EC50,GBM,Physchem,0,1.023745315,1.047595155,939,444,744,350,195,94
CHEMBL237_EC50,SVM,Physchem,0,1.045314848,1.098375626,939,444,744,350,195,94
CHEMBL237_EC50,KNN,Physchem,0,1.077146107,1.154593963,939,444,744,350,195,94
CHEMBL237_Ki,RF,Physchem,0,0.915742593,0.934207933,2547,1070,2020,844,527,226
CHEMBL237_Ki,GBM,Physchem,0,0.952434991,0.972964725,2547,1070,2020,844,527,226
CHEMBL237_Ki,SVM,Physchem,0,1.069931161,1.115495572,2547,1070,2020,844,527,226
CHEMBL237_Ki,KNN,Physchem,0,0.952371187,0.974124079,2547,1070,2020,844,527,226
CHEMBL238_Ki,RF,Physchem,0,0.758652738,0.819463262,1041,255,830,208,211,47
CHEMBL238_Ki,GBM,Physchem,0,0.771937717,0.844167693,1041,255,830,208,211,47
CHEMBL238_Ki,SVM,Physchem,0,0.931220725,0.998282165,1041,255,830,208,211,47
CHEMBL238_Ki,KNN,Physchem,0,0.783292002,0.86042413,1041,255,830,208,211,47
CHEMBL239_EC50,RF,Physchem,0,0.878841758,1.017446791,1709,692,1357,541,352,151
CHEMBL239_EC50,GBM,Physchem,0,0.907063209,1.040546538,1709,692,1357,541,352,151
CHEMBL239_EC50,SVM,Physchem,0,0.940945723,1.127313574,1709,692,1357,541,352,151
CHEMBL239_EC50,KNN,Physchem,0,0.901683351,1.034480449,1709,692,1357,541,352,151
CHEMBL244_Ki,RF,Physchem,0,1.135786829,1.146709166,3082,1447,2439,1154,643,293
CHEMBL244_Ki,GBM,Physchem,0,1.149509157,1.176448608,3082,1447,2439,1154,643,293
CHEMBL244_Ki,SVM,Physchem,0,1.185197554,1.190760438,3082,1447,2439,1154,643,293
CHEMBL244_Ki,KNN,Physchem,0,1.169572026,1.251660982,3082,1447,2439,1154,643,293
CHEMBL262_Ki,RF,Physchem,0,0.821007535,0.85540007,856,164,685,126,171,38
CHEMBL262_Ki,GBM,Physchem,0,0.860629983,0.938463972,856,164,685,126,171,38
CHEMBL262_Ki,SVM,Physchem,0,0.900902331,0.890513526,856,164,685,126,171,38
CHEMBL262_Ki,KNN,Physchem,0,0.903482191,0.845362324,856,164,685,126,171,38
CHEMBL264_Ki,RF,Physchem,0,0.82050726,0.863706426,2753,1092,2185,868,568,224
CHEMBL264_Ki,GBM,Physchem,0,0.83175146,0.876821043,2753,1092,2185,868,568,224
CHEMBL264_Ki,SVM,Physchem,0,0.934858422,1.014406275,2753,1092,2185,868,568,224
CHEMBL264_Ki,KNN,Physchem,0,0.858545534,0.924376075,2753,1092,2185,868,568,224
CHEMBL2835_Ki,RF,Physchem,0,0.533922353,0.868832828,609,54,485,43,124,11
CHEMBL2835_Ki,GBM,Physchem,0,0.512811745,0.795481759,609,54,485,43,124,11
CHEMBL2835_Ki,SVM,Physchem,0,0.517135644,0.875114475,609,54,485,43,124,11
CHEMBL2835_Ki,KNN,Physchem,0,0.496266997,1.014457344,609,54,485,43,124,11
CHEMBL287_Ki,RF,Physchem,0,0.799687802,0.909772867,1243,427,987,335,256,92
CHEMBL287_Ki,GBM,Physchem,0,0.808233309,0.936194761,1243,427,987,335,256,92
CHEMBL287_Ki,SVM,Physchem,0,0.827416171,0.884566511,1243,427,987,335,256,92
CHEMBL287_Ki,KNN,Physchem,0,0.849895486,0.935824793,1243,427,987,335,256,92
CHEMBL2971_Ki,RF,Physchem,0,0.745950868,0.617601,973,150,776,117,197,33
CHEMBL2971_Ki,GBM,Physchem,0,0.747631109,0.636475878,973,150,776,117,197,33
CHEMBL2971_Ki,SVM,Physchem,0,0.829443412,0.901021932,973,150,776,117,197,33
CHEMBL2971_Ki,KNN,Physchem,0,0.757168647,0.606258748,973,150,776,117,197,33
CHEMBL3979_EC50,RF,Physchem,0,0.867003044,0.918608438,1116,451,885,355,231,96
CHEMBL3979_EC50,GBM,Physchem,0,0.872327639,0.925078998,1116,451,885,355,231,96
CHEMBL3979_EC50,SVM,Physchem,0,0.944904081,0.959032429,1116,451,885,355,231,96
CHEMBL3979_EC50,KNN,Physchem,0,0.882099413,0.936742934,1116,451,885,355,231,96
CHEMBL4005_Ki,RF,Physchem,0,0.84050025,0.997362595,960,386,761,307,199,79
CHEMBL4005_Ki,GBM,Physchem,0,0.862400111,1.01584263,960,386,761,307,199,79
CHEMBL4005_Ki,SVM,Physchem,0,0.86310691,1.065705925,960,386,761,307,199,79
CHEMBL4005_Ki,KNN,Physchem,0,0.837263258,1.009473586,960,386,761,307,199,79
CHEMBL4203_Ki,RF,Physchem,0,0.852207025,0.827268442,731,64,589,49,142,15
CHEMBL4203_Ki,GBM,Physchem,0,0.838494404,0.870824661,731,64,589,49,142,15
CHEMBL4203_Ki,SVM,Physchem,0,0.840394725,0.794831511,731,64,589,49,142,15
CHEMBL4203_Ki,KNN,Physchem,0,0.900174427,0.948661134,731,64,589,49,142,15
CHEMBL4616_EC50,RF,Physchem,0,0.71174296,0.72569108,669,348,527,273,142,75
CHEMBL4616_EC50,GBM,Physchem,0,0.739335996,0.752931662,669,348,527,273,142,75
CHEMBL4616_EC50,SVM,Physchem,0,0.789635872,0.745170059,669,348,527,273,142,75
CHEMBL4616_EC50,KNN,Physchem,0,0.731317437,0.748720262,669,348,527,273,142,75
CHEMBL4792_Ki,RF,Physchem,0,0.784202785,0.88549232,1471,783,1166,624,305,159
CHEMBL4792_Ki,GBM,Physchem,0,0.784687743,0.859415012,1471,783,1166,624,305,159
CHEMBL4792_Ki,SVM,Physchem,0,0.779277708,0.855926847,1471,783,1166,624,305,159
CHEMBL4792_Ki,KNN,Physchem,0,0.808940671,0.895772016,1471,783,1166,624,305,159
CHEMBL1862_Ki,CNN,SMILES,10,1.255498531,0.891426476,790,329,630,261,160,68
CHEMBL1862_Ki,LSTM,SMILES,10,0.964639208,0.913950423,790,329,630,261,160,68
CHEMBL1871_Ki,CNN,SMILES,10,0.976422324,1.119321017,647,133,512,103,135,30
CHEMBL1871_Ki,LSTM,SMILES,10,1.012088896,0.882778098,647,133,512,103,135,30
CHEMBL2034_Ki,CNN,SMILES,10,0.939377155,0.919423868,750,245,592,191,158,54
CHEMBL2034_Ki,LSTM,SMILES,10,0.877692827,0.953835753,750,245,592,191,158,54
CHEMBL204_Ki,CNN,SMILES,10,1.328185004,1.240336895,2733,1060,2161,829,572,231
CHEMBL204_Ki,LSTM,SMILES,10,0.96145147,1.045474762,2733,1060,2161,829,572,231
CHEMBL2047_EC50,CNN,SMILES,10,0.825022916,0.834479815,631,245,498,197,133,48
CHEMBL2047_EC50,LSTM,SMILES,10,0.864039632,0.989977205,631,245,498,197,133,48
CHEMBL214_Ki,CNN,SMILES,10,0.921357168,0.923014755,3261,1161,2590,920,671,241
CHEMBL214_Ki,LSTM,SMILES,10,0.772975925,0.826507087,3261,1161,2590,920,671,241
CHEMBL2147_Ki,CNN,SMILES,10,1.714354936,1.045930822,1456,560,1163,449,293,111
CHEMBL2147_Ki,LSTM,SMILES,10,1.184680869,0.882044414,1456,560,1163,449,293,111
CHEMBL218_EC50,CNN,SMILES,10,0.930146924,0.828612254,1009,335,804,263,205,72
CHEMBL218_EC50,LSTM,SMILES,10,1.00327558,0.925744246,1009,335,804,263,205,72
CHEMBL219_Ki,CNN,SMILES,10,0.908896476,0.904637306,1834,700,1448,554,386,146
CHEMBL219_Ki,LSTM,SMILES,10,0.891445222,0.880317111,1834,700,1448,554,386,146
CHEMBL228_Ki,CNN,SMILES,10,1.013757831,0.953953387,1681,614,1332,484,349,130
CHEMBL228_Ki,LSTM,SMILES,10,0.902260539,0.914726474,1681,614,1332,484,349,130
CHEMBL231_Ki,CNN,SMILES,10,1.130976476,1.195944196,967,231,769,180,198,51
CHEMBL231_Ki,LSTM,SMILES,10,0.885295965,0.854001055,967,231,769,180,198,51
CHEMBL233_Ki,CNN,SMILES,10,1.045514341,1.052863445,3062,1215,2433,957,629,258
CHEMBL233_Ki,LSTM,SMILES,10,0.846793422,0.894116441,3062,1215,2433,957,629,258
CHEMBL234_Ki,CNN,SMILES,10,1.049188083,0.951764907,3619,1569,2876,1227,743,342
CHEMBL234_Ki,LSTM,SMILES,10,0.881050681,0.862339871,3619,1569,2876,1227,743,342
CHEMBL235_EC50,CNN,SMILES,10,0.895917141,0.980990467,2325,864,1857,689,468,175
CHEMBL235_EC50,LSTM,SMILES,10,1.510497354,1.795273963,2325,864,1857,689,468,175
CHEMBL236_Ki,CNN,SMILES,10,1.216918102,1.082090936,2547,983,2033,784,514,199
CHEMBL236_Ki,LSTM,SMILES,10,0.874467133,0.902982456,2547,983,2033,784,514,199
CHEMBL237_EC50,CNN,SMILES,10,1.182010481,1.182118364,939,444,744,350,195,94
CHEMBL237_EC50,LSTM,SMILES,10,1.353332583,1.351294688,939,444,744,350,195,94
CHEMBL237_Ki,CNN,SMILES,10,1.221318597,1.096235017,2547,1070,2020,844,527,226
CHEMBL237_Ki,LSTM,SMILES,10,1.051615987,1.098787585,2547,1070,2020,844,527,226
CHEMBL238_Ki,CNN,SMILES,10,0.934443456,0.903835818,1041,255,830,208,211,47
CHEMBL238_Ki,LSTM,SMILES,10,0.781922387,0.745824627,1041,255,830,208,211,47
CHEMBL239_EC50,CNN,SMILES,10,1.067765339,1.166964945,1709,692,1357,541,352,151
CHEMBL239_EC50,LSTM,SMILES,10,1.10364282,1.167983278,1709,692,1357,541,352,151
CHEMBL244_Ki,CNN,SMILES,10,1.424289515,1.298048636,3082,1447,2439,1154,643,293
CHEMBL244_Ki,LSTM,SMILES,10,0.918868708,1.017257252,3082,1447,2439,1154,643,293
CHEMBL262_Ki,CNN,SMILES,10,1.005382777,1.002589441,856,164,685,126,171,38
CHEMBL262_Ki,LSTM,SMILES,10,1.035323228,1.018612805,856,164,685,126,171,38
CHEMBL264_Ki,CNN,SMILES,10,0.930094816,0.948567211,2753,1092,2185,868,568,224
CHEMBL264_Ki,LSTM,SMILES,10,0.798746797,0.908470024,2753,1092,2185,868,568,224
CHEMBL2835_Ki,CNN,SMILES,10,0.786325292,0.781765502,609,54,485,43,124,11
CHEMBL2835_Ki,LSTM,SMILES,10,2.02633908,1.345775418,609,54,485,43,124,11
CHEMBL287_Ki,CNN,SMILES,10,1.101241146,1.164148744,1243,427,987,335,256,92
CHEMBL287_Ki,LSTM,SMILES,10,0.942162114,1.043660934,1243,427,987,335,256,92
CHEMBL2971_Ki,CNN,SMILES,10,1.27400907,1.121418636,973,150,776,117,197,33
CHEMBL2971_Ki,LSTM,SMILES,10,0.94257191,1.130431912,973,150,776,117,197,33
CHEMBL3979_EC50,CNN,SMILES,10,0.833660807,0.808001,1116,451,885,355,231,96
CHEMBL3979_EC50,LSTM,SMILES,10,0.760003067,0.802748594,1116,451,885,355,231,96
CHEMBL4005_Ki,CNN,SMILES,10,0.813152328,0.804270616,960,386,761,307,199,79
CHEMBL4005_Ki,LSTM,SMILES,10,0.833152538,0.913554422,960,386,761,307,199,79
CHEMBL4203_Ki,CNN,SMILES,10,0.94732638,0.828937969,731,64,589,49,142,15
CHEMBL4203_Ki,LSTM,SMILES,10,0.918461405,1.06989002,731,64,589,49,142,15
CHEMBL4616_EC50,CNN,SMILES,10,0.805612719,0.842927857,669,348,527,273,142,75
CHEMBL4616_EC50,LSTM,SMILES,10,0.837326102,0.89175481,669,348,527,273,142,75
CHEMBL4792_Ki,CNN,SMILES,10,0.839049793,0.847083054,1471,783,1166,624,305,159
CHEMBL4792_Ki,LSTM,SMILES,10,0.844401891,0.906441643,1471,783,1166,624,305,159
CHEMBL4203_Ki,RF,WHIM,0,0.876312159,0.792362932,731,64,589,49,142,15
CHEMBL4203_Ki,GBM,WHIM,0,0.898987601,0.77113456,731,64,589,49,142,15
CHEMBL4203_Ki,SVM,WHIM,0,0.900163702,0.792940153,731,64,589,49,142,15
CHEMBL4203_Ki,KNN,WHIM,0,0.943857823,0.930103849,731,64,589,49,142,15
CHEMBL2034_Ki,RF,WHIM,0,0.8101404,0.926569639,750,245,592,191,158,54
CHEMBL2034_Ki,GBM,WHIM,0,0.851008022,0.979463563,750,245,592,191,158,54
CHEMBL2034_Ki,SVM,WHIM,0,0.950227699,1.041033904,750,245,592,191,158,54
CHEMBL2034_Ki,KNN,WHIM,0,0.862759215,0.966951285,750,245,592,191,158,54
CHEMBL233_Ki,RF,WHIM,0,1.083877011,1.175637452,3062,1215,2433,957,629,258
CHEMBL233_Ki,GBM,WHIM,0,1.1100722,1.205148183,3062,1215,2433,957,629,258
CHEMBL233_Ki,SVM,WHIM,0,1.104284204,1.216963488,3062,1215,2433,957,629,258
CHEMBL233_Ki,KNN,WHIM,0,1.166779247,1.277517265,3062,1215,2433,957,629,258
CHEMBL4616_EC50,RF,WHIM,0,0.7852738,0.83549531,669,348,527,273,142,75
CHEMBL4616_EC50,GBM,WHIM,0,0.841428991,0.884191561,669,348,527,273,142,75
CHEMBL4616_EC50,SVM,WHIM,0,0.801759444,0.872922888,669,348,527,273,142,75
CHEMBL4616_EC50,KNN,WHIM,0,0.84027381,0.881367423,669,348,527,273,142,75
CHEMBL287_Ki,RF,WHIM,0,0.977038156,1.103462714,1243,427,987,335,256,92
CHEMBL287_Ki,GBM,WHIM,0,0.984945395,1.097540107,1243,427,987,335,256,92
CHEMBL287_Ki,SVM,WHIM,0,0.963700154,1.078138254,1243,427,987,335,256,92
CHEMBL287_Ki,KNN,WHIM,0,1.031112518,1.151872897,1243,427,987,335,256,92
CHEMBL218_EC50,RF,WHIM,0,0.87942799,0.962269937,1009,335,804,263,205,72
CHEMBL218_EC50,GBM,WHIM,0,0.901667942,1.004767086,1009,335,804,263,205,72
CHEMBL218_EC50,SVM,WHIM,0,0.928944082,0.976576431,1009,335,804,263,205,72
CHEMBL218_EC50,KNN,WHIM,0,0.927431286,0.984076684,1009,335,804,263,205,72
CHEMBL264_Ki,RF,WHIM,0,0.926445424,0.96325227,2753,1092,2185,868,568,224
CHEMBL264_Ki,GBM,WHIM,0,0.945190757,0.991218839,2753,1092,2185,868,568,224
CHEMBL264_Ki,SVM,WHIM,0,0.931763879,0.976624512,2753,1092,2185,868,568,224
CHEMBL264_Ki,KNN,WHIM,0,0.970189785,0.995712588,2753,1092,2185,868,568,224
CHEMBL219_Ki,RF,WHIM,0,0.899599428,0.895604562,1834,700,1448,554,386,146
CHEMBL219_Ki,GBM,WHIM,0,0.906594424,0.924144406,1834,700,1448,554,386,146
CHEMBL219_Ki,SVM,WHIM,0,0.934231411,0.907882111,1834,700,1448,554,386,146
CHEMBL219_Ki,KNN,WHIM,0,0.938885832,0.924956644,1834,700,1448,554,386,146
CHEMBL2835_Ki,RF,WHIM,0,0.532210931,0.886216726,609,54,485,43,124,11
CHEMBL2835_Ki,GBM,WHIM,0,0.506178939,0.842807091,609,54,485,43,124,11
CHEMBL2835_Ki,SVM,WHIM,0,0.582094554,0.971996987,609,54,485,43,124,11
CHEMBL2835_Ki,KNN,WHIM,0,0.538982284,0.877564118,609,54,485,43,124,11
CHEMBL2147_Ki,RF,WHIM,0,1.142140992,1.129994455,1456,560,1163,449,293,111
CHEMBL2147_Ki,GBM,WHIM,0,1.128642177,1.078430227,1456,560,1163,449,293,111
CHEMBL2147_Ki,SVM,WHIM,0,1.177531723,1.131690616,1456,560,1163,449,293,111
CHEMBL2147_Ki,KNN,WHIM,0,1.22098524,1.10710594,1456,560,1163,449,293,111
CHEMBL231_Ki,RF,WHIM,0,0.907011291,0.819508351,967,231,769,180,198,51
CHEMBL231_Ki,GBM,WHIM,0,0.921491256,0.854627173,967,231,769,180,198,51
CHEMBL231_Ki,SVM,WHIM,0,0.960082288,0.870172836,967,231,769,180,198,51
CHEMBL231_Ki,KNN,WHIM,0,0.915773504,0.853860226,967,231,769,180,198,51
CHEMBL3979_EC50,RF,WHIM,0,1.010254741,1.002796565,1116,451,885,355,231,96
CHEMBL3979_EC50,GBM,WHIM,0,1.01435478,0.996482589,1116,451,885,355,231,96
CHEMBL3979_EC50,SVM,WHIM,0,1.099004085,1.086796704,1116,451,885,355,231,96
CHEMBL3979_EC50,KNN,WHIM,0,1.081440759,1.028877854,1116,451,885,355,231,96
CHEMBL237_EC50,RF,WHIM,0,1.19659064,1.267609701,939,444,744,350,195,94
CHEMBL237_EC50,GBM,WHIM,0,1.175289429,1.19266,939,444,744,350,195,94
CHEMBL237_EC50,SVM,WHIM,0,1.266906857,1.326311185,939,444,744,350,195,94
CHEMBL237_EC50,KNN,WHIM,0,1.304082288,1.357040168,939,444,744,350,195,94
CHEMBL244_Ki,RF,WHIM,0,1.350640903,1.329825548,3082,1447,2439,1154,643,293
CHEMBL244_Ki,GBM,WHIM,0,1.375108563,1.334446086,3082,1447,2439,1154,643,293
CHEMBL244_Ki,SVM,WHIM,0,1.355330721,1.375158266,3082,1447,2439,1154,643,293
CHEMBL244_Ki,KNN,WHIM,0,1.3870003,1.370822696,3082,1447,2439,1154,643,293
CHEMBL4792_Ki,RF,WHIM,0,0.943848979,0.969810456,1471,783,1166,624,305,159
CHEMBL4792_Ki,GBM,WHIM,0,0.957767368,0.986139413,1471,783,1166,624,305,159
CHEMBL4792_Ki,SVM,WHIM,0,0.968159388,0.984241156,1471,783,1166,624,305,159
CHEMBL4792_Ki,KNN,WHIM,0,0.947569261,0.99144756,1471,783,1166,624,305,159
CHEMBL1871_Ki,RF,WHIM,0,0.738085283,0.850439581,647,133,512,103,135,30
CHEMBL1871_Ki,GBM,WHIM,0,0.74275455,0.837497579,647,133,512,103,135,30
CHEMBL1871_Ki,SVM,WHIM,0,0.765115828,0.82933995,647,133,512,103,135,30
CHEMBL1871_Ki,KNN,WHIM,0,0.74450123,0.821120041,647,133,512,103,135,30
CHEMBL237_Ki,RF,WHIM,0,1.091667098,1.089050124,2547,1070,2020,844,527,226
CHEMBL237_Ki,GBM,WHIM,0,1.119101121,1.101529772,2547,1070,2020,844,527,226
CHEMBL237_Ki,SVM,WHIM,0,1.157377202,1.183996398,2547,1070,2020,844,527,226
CHEMBL237_Ki,KNN,WHIM,0,1.161553429,1.172628251,2547,1070,2020,844,527,226
CHEMBL262_Ki,RF,WHIM,0,0.856748446,0.855307263,856,164,685,126,171,38
CHEMBL262_Ki,GBM,WHIM,0,0.855597547,0.883788024,856,164,685,126,171,38
CHEMBL262_Ki,SVM,WHIM,0,0.900475608,0.93112757,856,164,685,126,171,38
CHEMBL262_Ki,KNN,WHIM,0,0.89469784,0.90455129,856,164,685,126,171,38
CHEMBL2047_EC50,RF,WHIM,0,0.737595579,0.701071288,631,245,498,197,133,48
CHEMBL2047_EC50,GBM,WHIM,0,0.759280492,0.756344125,631,245,498,197,133,48
CHEMBL2047_EC50,SVM,WHIM,0,0.783262524,0.791520598,631,245,498,197,133,48
CHEMBL2047_EC50,KNN,WHIM,0,0.796926969,0.811935717,631,245,498,197,133,48
CHEMBL239_EC50,RF,WHIM,0,1.02474793,1.175878347,1709,692,1357,541,352,151
CHEMBL239_EC50,GBM,WHIM,0,1.03324093,1.182043997,1709,692,1357,541,352,151
CHEMBL239_EC50,SVM,WHIM,0,1.040952242,1.212330508,1709,692,1357,541,352,151
CHEMBL239_EC50,KNN,WHIM,0,1.059788423,1.223682996,1709,692,1357,541,352,151
CHEMBL2971_Ki,RF,WHIM,0,0.834975524,0.733801641,973,150,776,117,197,33
CHEMBL2971_Ki,GBM,WHIM,0,0.863440125,0.781047797,973,150,776,117,197,33
CHEMBL2971_Ki,SVM,WHIM,0,0.898929185,0.934806568,973,150,776,117,197,33
CHEMBL2971_Ki,KNN,WHIM,0,0.881098884,0.878942748,973,150,776,117,197,33
CHEMBL204_Ki,RF,WHIM,0,1.283083027,1.325815248,2733,1060,2161,829,572,231
CHEMBL204_Ki,GBM,WHIM,0,1.310524633,1.378359807,2733,1060,2161,829,572,231
CHEMBL204_Ki,SVM,WHIM,0,1.312499337,1.412982255,2733,1060,2161,829,572,231
CHEMBL204_Ki,KNN,WHIM,0,1.363312516,1.410907954,2733,1060,2161,829,572,231
CHEMBL214_Ki,RF,WHIM,0,1.010245176,1.051589613,3261,1161,2590,920,671,241
CHEMBL214_Ki,GBM,WHIM,0,1.034445216,1.079962073,3261,1161,2590,920,671,241
CHEMBL214_Ki,SVM,WHIM,0,1.055183209,1.107782193,3261,1161,2590,920,671,241
CHEMBL214_Ki,KNN,WHIM,0,1.056877773,1.082956568,3261,1161,2590,920,671,241
CHEMBL1862_Ki,RF,WHIM,0,0.935019614,0.876149658,790,329,630,261,160,68
CHEMBL1862_Ki,GBM,WHIM,0,0.925114903,0.890411856,790,329,630,261,160,68
CHEMBL1862_Ki,SVM,WHIM,0,1.013560569,1.008486758,790,329,630,261,160,68
CHEMBL1862_Ki,KNN,WHIM,0,1.037842216,0.921875844,790,329,630,261,160,68
CHEMBL234_Ki,RF,WHIM,0,0.999106828,0.976377647,3619,1569,2876,1227,743,342
CHEMBL234_Ki,GBM,WHIM,0,1.012854432,0.999310198,3619,1569,2876,1227,743,342
CHEMBL234_Ki,SVM,WHIM,0,1.026450108,1.000298729,3619,1569,2876,1227,743,342
CHEMBL234_Ki,KNN,WHIM,0,1.039143118,1.009187488,3619,1569,2876,1227,743,342
CHEMBL238_Ki,RF,WHIM,0,0.85172187,0.813312722,1041,255,830,208,211,47
CHEMBL238_Ki,GBM,WHIM,0,0.86735102,0.786324672,1041,255,830,208,211,47
CHEMBL238_Ki,SVM,WHIM,0,0.895162959,0.877416354,1041,255,830,208,211,47
CHEMBL238_Ki,KNN,WHIM,0,0.896101491,0.883631169,1041,255,830,208,211,47
CHEMBL235_EC50,RF,WHIM,0,0.994060018,1.098442645,2325,864,1857,689,468,175
CHEMBL235_EC50,GBM,WHIM,0,0.976213687,1.063953925,2325,864,1857,689,468,175
CHEMBL235_EC50,SVM,WHIM,0,1.023841515,1.154027187,2325,864,1857,689,468,175
CHEMBL235_EC50,KNN,WHIM,0,1.014275962,1.121732348,2325,864,1857,689,468,175
CHEMBL4005_Ki,RF,WHIM,0,0.953892481,0.971595325,960,386,761,307,199,79
CHEMBL4005_Ki,GBM,WHIM,0,0.929341273,0.958697354,960,386,761,307,199,79
CHEMBL4005_Ki,SVM,WHIM,0,0.970872495,0.970832199,960,386,761,307,199,79
CHEMBL4005_Ki,KNN,WHIM,0,0.981486889,0.972226954,960,386,761,307,199,79
CHEMBL236_Ki,RF,WHIM,0,1.095862901,1.135301265,2547,983,2033,784,514,199
CHEMBL236_Ki,GBM,WHIM,0,1.130845014,1.210887752,2547,983,2033,784,514,199
CHEMBL236_Ki,SVM,WHIM,0,1.159169466,1.217566268,2547,983,2033,784,514,199
CHEMBL236_Ki,KNN,WHIM,0,1.15812809,1.212967949,2547,983,2033,784,514,199
CHEMBL228_Ki,RF,WHIM,0,1.006259302,1.044583305,1681,614,1332,484,349,130
CHEMBL228_Ki,GBM,WHIM,0,1.017041046,1.056510844,1681,614,1332,484,349,130
CHEMBL228_Ki,SVM,WHIM,0,1.036573371,1.043813619,1681,614,1332,484,349,130
CHEMBL228_Ki,KNN,WHIM,0,1.022991992,1.059345638,1681,614,1332,484,349,130
